1111111111
1P000CE001
1000000111
1000110001
1111111111