111111111111111111111111
10P00C00000000E000000001
111111111111111111111111

111111111111111111111111
