111111111111111111111111111111111111111111
1E0000000000000C00000C00000000000000000111
101001010010000010100100000000000001010111
101001001010101000100100000000000001010111
1P0000000C00C0000000000000000000000000C111
111111111111111111111111111111111111111111