111111111111
100000000001
10P000C00001
100000B00BE1
111111111111