111111111111111111111111111111111111111
100000000000000000000000000000000000001
10P000000000000000000000000000C00000001
100000000000000000000000000000000000001
1000000000B0000000000000000000000000001
100000000000000000000000000000000000001
10000B00000000000000BBBBBBBBBBBBBBBB001
100000000000000000000000000000B000BBB01
10000000000000000000000000000000B0EBBC1
10000000000000000000BBBBBBBBBBBBBBBBB01
10000000000C000000000000000000000000001
111111111111111111111111111111111111111