111111111111111111111111111111
0000000000E0000000000000000001
1000000000P000000000000C000001
111111111111111111111111111111
